#######################
#.....................#
#.#########..########.# 
#.....................#
#.####.####.####.######
#.....................#
#...#..##..##...###.###
#.....................#
#######################